PPPPPPPPPPPPWPPPPPPWPPPPPPWPPPPPWPPWPPWPPPPWPPPPPPPPPPPPPPPPPPPPPPP
...................................................................
...................................................................
...................................................................
...................................................................
...................................................................
OOOOOOOOOOOOXOOOOOXOOOOXOOOOOXOOOOOOXOOOOXOOOOOOOOOFOOOOOOOOOOOOOOO
