PPPPWPPWPPWPPWPPWPPWPPPPWPPPPPWPPPWPPPWPPWPPWPPWPPPWPPPPWPPPWPPWPPWPPWPPWPPWPPWPPWPPPPPPPPPPPPPPPPPPPPPPPPPP
............................................................................................................
............................................................................................................
............................................................................................................
............................................................................................................
............................................................................................................
OOOXOOOXOOOXOOOXOOOXOOOXOOOXOOOXOOXOOXOOXOOXOOXOOXOOXOOXOOXOOXOOXOOXOOXOOXOOXOOXOOXOOOFOOOOOOOOOOOOOOOOOOOOO
