PPPPPPWPPPWPPPPWPPPPWPPPPWPPPWPPPPWPPPPWPPPPWPPPPWPPPPWPPPWPPWPPWPPPWPPPPPPPPPPPPPPP
....................................................................................
....................................................................................
....................................................................................
....................................................................................
....................................................................................
OOOXOOXOOXOOOXOOXOOOXOOOOOXOOOXOOOOXOOOXOOOXOOXOOXOOOXOOOXOOOXOOXOOOOOOFOOOOOOOOOOOO
